NO ./sprite/brick_wall.ppm
SO ./sprite/brick_wall.ppm
EA ./sprite/brick_wall.ppm
WE ./sprite/brick_wall.ppm

1111
1001
10E1
1111
