111111111
101000001
101000001
100000001
100000001
101001001
100001001
111111111