11111111
10100001
10100001
10000001
10000001
11000101
11000101
11111111
