11111111
10100001
10100001
10000001
10000001
10100101
10000101
11111111