NO ./sprite/brick_wall.ppm
SO ./sprite/brick_wall.ppm
EA ./sprite/brick_wall.ppm
WE ./sprite/brick_wall.ppm

111111111111111111
11110000000001111
   1100000000000111111111
1111000000000000000000001
11000000E0000000011111111
111111111111111111
